0,7,5,48,15,2,12,25,20,5
7,0,31,22,19,29,21,49,39,5
5,31,0,12,44,4,33,3,9,9
48,22,12,0,28,45,24,26,3,24
15,19,44,28,0,1,6,27,35,23
2,29,4,45,1,0,31,24,1,34
12,21,33,24,6,31,0,22,41,17
25,49,3,26,27,24,22,0,8,14
20,39,9,3,35,1,41,8,0,17
5,5,9,24,23,34,17,14,17,0
