0,7,2,4,7,6,7,2,5,9
7,0,6,9,10,8,1,4,5,9
2,6,0,4,2,5,4,3,9,1
4,9,4,0,2,2,6,4,7,3
7,10,2,2,0,7,5,6,10,9
6,8,5,2,7,0,4,10,2,8
7,1,4,6,5,4,0,4,7,7
2,4,3,4,6,10,4,0,5,1
5,5,9,7,10,2,7,5,0,1
9,9,1,3,9,8,7,1,1,0
