0,7,24,32,34,23,42,39,27,18
7,0,45,22,6,28,2,34,35,34
24,45,0,14,41,21,38,11,32,8
32,22,14,0,21,41,41,44,14,25
34,6,41,21,0,45,36,36,32,39
23,28,21,41,45,0,30,8,35,45
42,2,38,41,36,30,0,34,50,7
39,34,11,44,36,8,34,0,23,30
27,35,32,14,32,35,50,23,0,14
18,34,8,25,39,45,7,30,14,0
