0,2,10,6,10,7,7,6,10,6
4,0,4,3,1,7,9,6,6,1
9,4,0,6,3,10,3,5,4,4
7,3,10,0,2,1,7,8,9,9
5,7,10,2,0,1,7,7,3,4
1,8,2,3,3,0,4,10,10,2
4,8,3,8,5,10,0,8,5,4
6,10,6,10,4,2,8,0,1,1
1,9,2,1,4,9,1,3,0,8
1,10,5,5,6,10,8,7,9,0
