0,33,6,14,19,24,6,50,43,48
9,0,26,21,37,16,19,13,3,4
23,32,0,23,6,47,4,40,19,19
17,33,30,0,7,30,27,3,5,1
9,8,50,30,0,41,29,50,4,19
25,14,18,9,27,0,9,47,41,43
6,13,44,6,11,19,0,46,35,19
35,29,37,9,44,32,27,0,46,14
11,20,32,10,2,40,24,30,0,21
35,34,24,22,41,21,40,4,11,0
