0,5,10,6,10,7,6,5,6,6
7,0,9,9,4,9,2,2,2,6
9,3,0,2,5,1,3,9,6,10
2,3,2,0,1,2,9,8,2,5
3,8,6,1,0,6,4,10,6,5
6,4,5,10,6,0,3,2,3,10
7,6,10,7,5,1,0,4,2,9
10,7,5,7,9,6,2,0,8,8
8,1,8,6,9,1,4,3,0,8
6,9,10,2,6,5,9,10,9,0
