0,1,6,3,5,7,7,1,2,3
1,0,3,7,2,9,1,10,5,9
6,3,0,6,10,2,3,7,8,8
3,7,6,0,9,3,4,3,2,6
5,2,10,9,0,7,3,5,4,7
7,9,2,3,7,0,8,2,6,3
7,1,3,4,3,8,0,7,5,6
1,10,7,3,5,2,7,0,1,7
2,5,8,2,4,6,5,1,0,5
3,9,8,6,7,3,6,7,5,0
