0,28,3,21,2,18,30,1,24,19
28,0,38,28,41,25,36,2,2,46
3,38,0,15,50,41,12,38,12,33
21,28,15,0,20,41,35,49,48,29
2,41,50,20,0,21,43,41,28,10
18,25,41,41,21,0,26,29,26,40
30,36,12,35,43,26,0,48,21,42
1,2,38,49,41,29,48,0,45,5
24,2,12,48,28,26,21,45,0,46
19,46,33,29,10,40,42,5,46,0
