0,10,5,10,2,4,6,10,6,8
10,0,2,7,1,4,3,6,3,3
5,2,0,5,3,4,10,4,6,2
10,7,5,0,8,4,2,9,4,9
2,1,3,8,0,6,9,3,8,3
4,4,4,4,6,0,4,3,2,8
6,3,10,2,9,4,0,10,10,6
10,6,4,9,3,3,10,0,3,2
6,3,6,4,8,2,10,3,0,2
8,3,2,9,3,8,6,2,2,0
