0,34,48,39,3,12,4,19,13,8
25,0,5,10,47,5,36,14,26,6
2,33,0,36,35,42,14,40,29,3
23,9,25,0,50,38,37,7,33,20
4,4,30,23,0,3,8,31,7,28
30,11,37,22,1,0,1,40,18,21
13,44,47,24,40,14,0,13,4,10
37,20,29,14,50,4,34,0,30,39
11,21,10,33,15,45,41,13,0,9
39,4,49,22,21,17,14,40,37,0
