0,6,19,49,23,29,9,18,22,25
6,0,6,8,30,24,3,25,11,29
19,6,0,47,7,32,6,44,25,12
49,8,47,0,25,7,20,23,26,42
23,30,7,25,0,31,45,25,26,12
29,24,32,7,31,0,41,36,50,30
9,3,6,20,45,41,0,8,38,2
18,25,44,23,25,36,8,0,20,1
22,11,25,26,26,50,38,20,0,4
25,29,12,42,12,30,2,1,4,0
