0,36,27,11,48,39,44,3,25,10
36,0,47,15,30,39,34,48,39,44
27,47,0,14,10,4,45,46,41,28
11,15,14,0,38,1,49,14,43,46
48,30,10,38,0,46,28,47,18,5
39,39,4,1,46,0,12,26,27,36
44,34,45,49,28,12,0,32,15,23
3,48,46,14,47,26,32,0,22,5
25,39,41,43,18,27,15,22,0,26
10,44,28,46,5,36,23,5,26,0
