0,12,22,41,20,40,50,42,41,7
34,0,22,19,9,6,47,9,7,48
47,28,0,8,50,17,27,39,3,37
8,7,14,0,29,35,14,17,17,9
17,48,49,12,0,18,5,48,42,14
41,30,34,34,5,0,4,27,37,35
41,17,7,39,41,47,0,35,37,45
2,31,50,33,29,36,50,0,2,4
31,38,47,28,14,2,37,11,0,25
7,2,28,34,45,37,8,46,23,0
