0,32,34,14,47,28,38,28,49,24
32,0,46,41,5,15,49,46,6,10
34,46,0,7,2,21,1,38,37,13
14,41,7,0,22,33,27,15,1,21
47,5,2,22,0,5,12,40,6,29
28,15,21,33,5,0,26,16,19,33
38,49,1,27,12,26,0,9,45,38
28,46,38,15,40,16,9,0,28,22
49,6,37,1,6,19,45,28,0,47
24,10,13,21,29,33,38,22,47,0
