0,43,27,5,41,12,21,21,38,15
9,0,33,6,27,1,15,12,19,15
15,32,0,18,16,42,30,11,17,14
32,38,14,0,14,3,38,14,41,14
18,29,4,33,0,8,36,21,37,28
22,46,12,10,10,0,20,16,11,25
37,33,41,17,2,20,0,9,44,16
4,32,19,47,26,32,28,0,36,34
9,26,26,18,27,39,11,26,0,20
34,33,41,4,14,10,21,30,13,0
