0,37,40,9,45,20,14,27,5,50
27,0,44,1,4,4,31,49,29,48
10,34,0,11,22,28,21,29,45,2
49,20,9,0,14,1,13,9,20,20
7,12,48,21,0,21,26,8,2,42
12,31,13,17,28,0,22,11,20,20
23,32,27,2,1,11,0,31,3,28
21,46,19,4,18,25,35,0,41,3
36,17,36,23,10,48,16,13,0,23
3,29,47,50,9,23,12,12,32,0
