0,48,23,44,42,38,28,25,34,11
32,0,15,34,15,38,49,23,25,17
1,36,0,41,5,45,38,35,28,35
25,17,18,0,33,49,5,22,16,14
5,7,13,40,0,11,29,40,44,26
3,50,31,10,46,0,14,4,29,40
22,1,8,9,5,3,0,12,49,5
18,35,37,13,36,14,20,0,34,23
8,27,30,34,23,49,6,10,0,44
35,34,17,39,18,9,13,13,15,0
