0,50,8,38,41,13,39,3,26,38
50,0,30,17,25,41,34,12,21,50
8,30,0,10,37,23,16,7,16,9
38,17,10,0,39,13,8,34,26,41
41,25,37,39,0,37,8,3,17,15
13,41,23,13,37,0,17,46,18,36
39,34,16,8,8,17,0,19,45,30
3,12,7,34,3,46,19,0,34,10
26,21,16,26,17,18,45,34,0,40
38,50,9,41,15,36,30,10,40,0
