0,1,14,4,50,39,41,12,15,36
3,0,49,45,46,9,22,50,29,48
21,49,0,32,42,29,43,10,25,45
39,5,18,0,40,48,28,2,15,14
15,39,4,9,0,10,8,49,10,14
27,30,43,5,9,0,50,46,32,28
24,34,1,28,27,2,0,22,49,5
23,34,7,14,32,15,18,0,25,4
25,21,40,41,31,16,36,2,0,12
17,28,37,14,9,31,3,47,38,0
