0,35,45,21,6,33,46,30,36,34
35,0,21,20,12,21,3,42,34,38
45,21,0,48,28,43,18,34,48,15
21,20,48,0,2,12,35,31,1,30
6,12,28,2,0,13,36,24,7,7
33,21,43,12,13,0,32,41,14,23
46,3,18,35,36,32,0,9,44,8
30,42,34,31,24,41,9,0,22,5
36,34,48,1,7,14,44,22,0,33
34,38,15,30,7,23,8,5,33,0
