0,6,10,2,2,3,10,9,1,4
1,0,3,1,2,8,5,8,7,4
6,9,0,3,7,7,3,7,7,2
3,10,9,0,1,8,3,1,1,8
9,2,7,9,0,1,6,9,4,3
3,7,7,1,4,0,6,8,6,8
10,10,8,2,8,1,0,10,7,5
8,5,10,2,2,9,4,0,3,8
3,9,4,5,9,9,7,9,0,9
9,1,7,7,5,1,5,8,2,0
