0,46,16,34,14,6,41,4,5,5
7,0,5,47,42,43,34,6,10,14
46,20,0,19,16,6,36,48,19,17
31,18,12,0,16,47,43,29,44,35
13,46,40,4,0,39,39,41,21,39
31,33,9,22,10,0,49,5,21,23
21,36,29,14,31,35,0,25,43,39
31,40,32,16,37,12,6,0,38,25
30,35,7,5,23,23,34,32,0,34
12,49,4,43,19,29,43,28,33,0
