0,26,50,40,21,44,14,46,5,7
26,0,35,22,24,27,17,15,21,44
50,35,0,13,9,5,41,26,37,11
40,22,13,0,5,45,18,42,27,8
21,24,9,5,0,46,46,46,37,39
44,27,5,45,46,0,33,6,27,43
14,17,41,18,46,33,0,29,42,31
46,15,26,42,46,6,29,0,20,3
5,21,37,27,37,27,42,20,0,5
7,44,11,8,39,43,31,3,5,0
