0,15,21,4,36,41,41,36,8,35
37,0,8,29,1,2,39,44,13,41
28,30,0,48,32,36,41,27,17,8
30,4,49,0,14,14,20,27,31,50
15,25,39,45,0,2,25,23,2,29
3,9,6,40,15,0,3,16,46,34
21,15,13,29,21,12,0,25,48,48
21,45,27,16,21,25,17,0,13,37
40,29,40,29,31,23,37,27,0,9
48,39,43,16,26,20,12,19,37,0
