0,45,28,21,41,45,23,19,19,9
15,0,27,40,25,30,34,17,34,19
44,43,0,8,32,28,38,47,4,49
28,25,49,0,17,49,9,24,17,5
44,34,33,7,0,47,32,41,3,35
47,47,37,30,27,0,20,28,31,39
6,45,14,36,3,12,0,24,33,45
47,17,39,31,34,46,31,0,19,3
12,23,20,10,46,9,8,35,0,15
47,25,23,14,2,48,11,45,46,0
