0,3,46,11,47,6,5,12,9,38
3,0,19,35,47,13,25,17,8,36
46,19,0,45,23,32,19,14,50,49
11,35,45,0,30,3,35,4,41,31
47,47,23,30,0,10,2,32,2,28
6,13,32,3,10,0,50,47,13,38
5,25,19,35,2,50,0,33,34,23
12,17,14,4,32,47,33,0,31,34
9,8,50,41,2,13,34,31,0,12
38,36,49,31,28,38,23,34,12,0
