0,43,20,27,42,23,42,12,3,2,13
43,0,7,46,20,10,11,30,14,31,43
20,7,0,3,44,26,37,2,3,20,27
27,46,3,0,3,19,24,42,14,5,7
42,20,44,3,0,2,7,23,43,28,49
23,10,26,19,2,0,41,17,37,45,28
42,11,37,24,7,41,0,3,35,6,22
12,30,2,42,23,17,3,0,50,3,45
3,14,3,14,43,37,35,50,0,45,47
2,31,20,5,28,45,6,3,45,0,15
13,43,27,7,49,28,22,45,47,15,0
