0,40,32,12,39,47,45,26,40,23,21
40,0,33,7,24,38,23,23,36,26,40
32,33,0,17,14,1,30,4,5,7,6
12,7,17,0,39,11,32,41,13,20,19
39,24,14,39,0,43,4,15,13,42,7
47,38,1,11,43,0,22,34,27,30,45
45,23,30,32,4,22,0,41,47,37,50
26,23,4,41,15,34,41,0,35,23,33
40,36,5,13,13,27,47,35,0,34,3
23,26,7,20,42,30,37,23,34,0,29
21,40,6,19,7,45,50,33,3,29,0
