0,8,5,1,5,5,3,1,7,7,5
10,0,4,2,8,4,8,3,5,1,9
5,9,0,3,1,7,2,5,10,8,1
2,6,8,0,9,2,4,7,9,5,3
6,3,2,1,0,9,7,9,1,8,4
7,8,10,8,10,0,3,10,9,4,7
8,8,3,6,9,2,0,3,3,7,6
8,1,1,2,8,2,1,0,2,2,6
1,2,9,4,1,7,5,5,0,6,3
1,10,4,10,4,9,4,6,5,0,1
7,4,10,10,8,1,1,3,10,3,0
