0,10,10,8,3,5,2,5,3,8,8
2,0,2,10,6,2,4,6,5,8,9
4,7,0,7,9,8,7,8,1,3,7
7,10,7,0,5,1,2,8,7,5,10
4,1,7,7,0,10,2,8,8,7,2
2,1,6,2,1,0,4,5,2,8,10
5,4,6,9,9,9,0,3,3,4,9
1,3,6,4,3,9,1,0,8,10,1
8,2,7,9,3,7,2,4,0,3,4
8,4,2,6,5,3,6,4,8,0,8
6,7,10,7,1,1,2,9,4,10,0
