0,10,4,6,6,10,10,4,9,5,1
3,0,1,3,6,9,8,4,3,1,4
3,10,0,9,9,5,2,2,7,3,7
5,1,2,0,10,9,5,8,4,1,5
10,3,3,6,0,5,9,7,5,2,8
5,6,1,2,1,0,9,4,7,3,3
9,3,5,7,10,1,0,1,1,8,8
6,9,9,3,7,4,3,0,9,5,5
4,9,6,8,7,4,8,3,0,8,7
9,2,7,1,2,6,6,1,8,0,10
4,3,1,4,1,8,6,3,9,3,0
