0,47,8,16,23,15,24,28,47,23,42
13,0,48,17,45,2,17,13,34,18,16
50,48,0,16,35,16,3,18,30,37,37
28,14,26,0,31,46,25,42,49,41,32
1,16,49,40,0,22,9,35,13,26,1
32,5,21,3,27,0,44,41,31,14,31
42,21,11,21,30,32,0,7,8,37,27
5,28,13,38,10,26,33,0,18,20,48
32,42,24,20,19,10,50,17,0,45,26
3,5,34,30,38,4,16,11,14,0,14
4,38,45,35,49,34,23,17,27,8,0
