0,26,50,33,27,15,30,27,37,37,33
26,0,41,2,40,35,8,2,46,19,21
50,41,0,6,3,29,38,34,46,33,33
33,2,6,0,44,40,16,49,39,8,15
27,40,3,44,0,19,42,33,25,29,21
15,35,29,40,19,0,16,3,30,41,6
30,8,38,16,42,16,0,3,49,38,37
27,2,34,49,33,3,3,0,5,42,15
37,46,46,39,25,30,49,5,0,10,19
37,19,33,8,29,41,38,42,10,0,9
33,21,33,15,21,6,37,15,19,9,0
