0,25,38,38,9,39,44,32,30,26,39
6,0,48,8,37,30,23,14,37,32,30
21,13,0,17,46,45,36,41,40,20,19
26,35,30,0,29,49,30,29,46,22,47
9,27,42,44,0,48,30,32,31,43,4
48,1,40,49,39,0,22,16,3,5,8
43,32,2,21,39,2,0,12,33,31,6
40,27,40,18,7,41,48,0,12,28,10
12,21,20,24,47,41,6,40,0,24,28
48,47,36,20,35,22,49,45,1,0,16
3,21,49,7,43,38,38,4,29,33,0
