0,29,12,45,27,16,12,17,26,47,30
42,0,14,15,17,48,44,16,34,27,36
35,38,0,9,18,34,11,2,44,32,23
5,10,36,0,22,30,2,11,17,9,36
32,9,33,1,0,38,50,27,40,25,16
37,20,1,1,30,0,1,47,4,7,24
46,38,4,10,46,15,0,26,3,49,7
30,27,43,47,17,23,45,0,42,12,40
41,50,29,49,26,42,9,47,0,9,7
46,26,2,10,35,10,45,38,46,0,47
15,36,23,47,21,29,20,18,17,26,0
