0,22,30,25,5,49,28,12,40,6,21
22,0,2,34,47,25,40,35,22,47,33
30,2,0,27,23,6,13,29,39,42,13
25,34,27,0,45,26,21,27,33,19,10
5,47,23,45,0,43,14,40,34,6,34
49,25,6,26,43,0,19,35,39,5,13
28,40,13,21,14,19,0,12,50,21,5
12,35,29,27,40,35,12,0,13,41,16
40,22,39,33,34,39,50,13,0,3,31
6,47,42,19,6,5,21,41,3,0,8
21,33,13,10,34,13,5,16,31,8,0
