0,41,4,43,33,1,32,6,20,17,27
41,0,38,19,3,24,25,26,11,38,27
4,38,0,43,43,11,33,2,20,30,10
43,19,43,0,35,9,13,40,13,17,48
33,3,43,35,0,26,15,41,19,27,44
1,24,11,9,26,0,43,25,1,45,1
32,25,33,13,15,43,0,9,48,12,39
6,26,2,40,41,25,9,0,15,36,46
20,11,20,13,19,1,48,15,0,21,45
17,38,30,17,27,45,12,36,21,0,40
27,27,10,48,44,1,39,46,45,40,0
