0,2,43,48,41,33,29,20,35,8,21
50,0,16,8,22,48,39,49,34,48,41
50,40,0,16,2,48,35,37,50,7,30
10,4,12,0,28,4,41,9,18,46,22
48,26,22,25,0,50,23,42,14,43,35
3,42,43,8,19,0,19,39,10,50,22
29,33,4,32,24,47,0,31,40,37,15
35,49,20,7,24,38,21,0,22,15,40
38,11,17,47,8,13,19,46,0,6,40
35,26,35,23,47,49,14,5,50,0,16
19,30,48,33,1,39,21,11,19,23,0
