0,5,1,9,7,2,5,9,3,3,8
5,0,8,3,5,3,9,3,5,9,7
1,8,0,8,9,8,2,2,8,3,8
9,3,8,0,3,9,4,8,3,8,4
7,5,9,3,0,7,10,4,3,3,5
2,3,8,9,7,0,3,8,7,9,5
5,9,2,4,10,3,0,10,8,1,7
9,3,2,8,4,8,10,0,9,6,7
3,5,8,3,3,7,8,9,0,10,2
3,9,3,8,3,9,1,6,10,0,4
8,7,8,4,5,5,7,7,2,4,0
