0,3,4,4,9,7,3,4,8,9,9
3,0,4,3,1,1,3,1,5,9,7
4,4,0,5,10,1,7,3,3,10,1
4,3,5,0,6,7,5,1,5,2,10
9,1,10,6,0,10,4,8,6,7,10
7,1,1,7,10,0,5,9,5,5,10
3,3,7,5,4,5,0,3,9,1,10
4,1,3,1,8,9,3,0,4,2,10
8,5,3,5,6,5,9,4,0,8,5
9,9,10,2,7,5,1,2,8,0,8
9,7,1,10,10,10,10,10,5,8,0
