0,22,23,8,22,16,12,38,24,29,3
12,0,7,19,25,33,43,25,10,2,10
15,47,0,13,7,35,31,33,28,31,47
34,16,5,0,31,34,48,1,27,48,42
41,43,27,16,0,49,14,4,26,7,48
12,14,12,33,31,0,39,37,11,34,18
44,7,22,44,5,32,0,38,15,29,17
11,42,13,7,50,24,1,0,20,42,45
36,13,15,29,25,3,32,8,0,46,16
24,42,20,8,28,30,50,2,23,0,17
38,27,3,9,1,23,17,19,37,10,0
