0,50,29,17,42,11,9,10,23,42,32
50,0,1,29,34,15,30,45,25,29,50
29,1,0,36,37,47,3,38,42,2,13
17,29,36,0,11,13,16,1,5,42,49
42,34,37,11,0,27,14,22,26,23,1
11,15,47,13,27,0,36,19,20,17,49
9,30,3,16,14,36,0,27,44,27,38
10,45,38,1,22,19,27,0,38,33,41
23,25,42,5,26,20,44,38,0,28,21
42,29,2,42,23,17,27,33,28,0,8
32,50,13,49,1,49,38,41,21,8,0
