0,19,36,38,32,2,45,28,18,15,36
39,0,9,16,23,33,42,14,28,24,47
23,32,0,21,9,37,49,24,7,10,46
11,48,39,0,40,31,23,22,35,5,18
41,5,31,33,0,47,16,39,21,11,7
26,47,47,30,50,0,36,1,2,1,3
29,2,11,9,49,8,0,14,15,48,2
1,20,26,29,48,24,4,0,38,47,32
5,27,15,23,12,26,42,22,0,26,38
34,50,15,19,30,42,17,1,14,0,33
26,35,31,19,28,3,35,44,46,3,0
