0,39,33,32,39,4,49,25,34,2,27
39,0,29,27,3,8,29,34,42,10,20
33,29,0,14,40,6,13,29,41,19,13
32,27,14,0,40,32,39,37,40,19,17
39,3,40,40,0,17,21,16,28,46,17
4,8,6,32,17,0,16,18,41,21,17
49,29,13,39,21,16,0,21,19,1,23
25,34,29,37,16,18,21,0,29,47,42
34,42,41,40,28,41,19,29,0,10,41
2,10,19,19,46,21,1,47,10,0,47
27,20,13,17,17,17,23,42,41,47,0
