0,3,11,16,32,48,9,29,13,49,19
9,0,49,2,30,43,29,37,40,22,38
32,29,0,2,13,42,47,10,40,39,21
38,22,28,0,50,16,49,13,21,9,32
42,35,15,29,0,20,27,43,10,20,16
8,27,17,5,46,0,40,33,20,50,29
5,24,8,45,41,13,0,22,20,46,20
48,38,7,47,22,7,45,0,27,13,28
34,8,11,41,12,19,28,32,0,41,30
31,31,9,20,31,13,46,27,28,0,42
38,1,33,50,37,12,13,23,31,14,0
