0,43,19,49,21,18,11,10,35,49,37
43,0,44,20,44,19,11,45,29,8,25
19,44,0,9,12,10,12,10,2,29,13
49,20,9,0,23,3,33,32,41,27,41
21,44,12,23,0,46,23,4,23,32,6
18,19,10,3,46,0,50,4,23,24,18
11,11,12,33,23,50,0,16,21,33,28
10,45,10,32,4,4,16,0,39,42,32
35,29,2,41,23,23,21,39,0,7,7
49,8,29,27,32,24,33,42,7,0,17
37,25,13,41,6,18,28,32,7,17,0
