0,5,29,28,35,24,32,32,36,31,27
39,0,34,42,30,45,7,16,19,25,26
8,49,0,36,28,43,2,34,38,11,20
45,45,7,0,35,13,39,7,13,13,29
4,33,48,18,0,1,47,12,47,13,11
20,32,19,31,39,0,6,8,35,26,2
39,46,19,29,30,28,0,15,19,39,28
23,4,2,20,28,31,12,0,33,2,40
15,5,41,50,41,19,15,49,0,49,41
20,37,45,16,47,7,17,20,3,0,11
28,40,17,12,24,24,23,12,38,2,0
