0,1,8,10,1,9,3,4,4,5,2
1,0,5,7,5,5,7,5,9,4,10
8,5,0,1,7,1,10,4,1,6,3
10,7,1,0,9,8,1,9,3,6,9
1,5,7,9,0,3,5,9,6,8,2
9,5,1,8,3,0,2,3,4,4,4
3,7,10,1,5,2,0,5,4,8,3
4,5,4,9,9,3,5,0,6,5,8
4,9,1,3,6,4,4,6,0,3,10
5,4,6,6,8,4,8,5,3,0,5
2,10,3,9,2,4,3,8,10,5,0
