0,28,16,39,13,48,27,44,11,45,15
50,0,36,33,3,26,33,39,29,33,30
40,15,0,9,3,35,14,49,38,10,36
8,32,7,0,17,30,27,34,32,6,37
31,29,13,19,0,41,38,13,14,26,45
36,37,24,26,29,0,9,28,12,36,29
16,7,8,38,9,12,0,31,21,18,2
30,43,2,9,35,17,33,0,50,15,32
21,18,38,12,26,6,19,50,0,31,33
30,29,36,9,35,42,22,23,38,0,7
31,3,26,16,5,7,41,38,28,7,0
