0,27,28,44,3,46,30,42,26,19,40
11,0,14,44,29,43,36,11,36,15,31
16,42,0,19,23,45,41,49,3,6,1
17,23,47,0,19,37,2,44,38,11,8
33,47,47,16,0,36,17,9,22,26,41
49,32,31,13,19,0,40,28,45,14,27
7,33,39,33,27,3,0,39,4,20,13
28,49,22,44,5,24,24,0,24,7,47
50,25,4,43,35,18,42,11,0,23,10
11,14,5,38,42,42,42,16,33,0,19
5,7,17,7,26,44,50,6,8,41,0
