0,2,26,27,1,3,34,5,28,32,40
2,0,9,25,49,18,30,43,47,18,15
26,9,0,22,21,1,7,7,17,13,30
27,25,22,0,43,50,17,4,19,30,30
1,49,21,43,0,48,13,20,28,48,41
3,18,1,50,48,0,22,21,19,26,35
34,30,7,17,13,22,0,33,11,14,39
5,43,7,4,20,21,33,0,43,25,18
28,47,17,19,28,19,11,43,0,28,40
32,18,13,30,48,26,14,25,28,0,37
40,15,30,30,41,35,39,18,40,37,0
