0,4,21,26,11,18,46,11,44,6,14
4,0,31,19,19,23,18,33,11,2,10
21,31,0,48,36,32,30,47,26,20,31
26,19,48,0,41,41,43,7,21,3,18
11,19,36,41,0,3,2,23,3,15,11
18,23,32,41,3,0,11,50,4,16,30
46,18,30,43,2,11,0,7,3,39,12
11,33,47,7,23,50,7,0,4,23,24
44,11,26,21,3,4,3,4,0,47,24
6,2,20,3,15,16,39,23,47,0,39
14,10,31,18,11,30,12,24,24,39,0
