0,45,30,26,11,18,18,15,40,22,44,9
45,0,17,8,16,47,9,13,47,43,33,48
30,17,0,12,13,15,23,1,46,48,2,48
26,8,12,0,3,9,20,21,22,16,7,37
11,16,13,3,0,42,24,4,48,13,13,34
18,47,15,9,42,0,42,26,37,17,17,13
18,9,23,20,24,42,0,49,28,21,26,2
15,13,1,21,4,26,49,0,46,16,27,33
40,47,46,22,48,37,28,46,0,24,13,19
22,43,48,16,13,17,21,16,24,0,4,48
44,33,2,7,13,17,26,27,13,4,0,44
9,48,48,37,34,13,2,33,19,48,44,0
