0,38,2,21,48,24,32,28,16,17,39,49
32,0,1,34,37,4,8,44,49,5,1,6
37,33,0,5,48,19,38,39,18,50,44,5
35,35,32,0,18,40,17,7,15,12,23,30
2,32,27,44,0,20,2,27,21,48,36,49
1,34,30,29,48,0,36,1,9,47,46,25
44,24,17,44,24,34,0,39,23,23,15,39
41,28,34,24,31,32,39,0,6,44,32,48
39,22,13,5,2,7,42,41,0,20,43,34
10,42,49,32,21,5,8,26,45,0,9,8
1,37,37,21,21,34,20,22,48,3,0,8
47,34,33,34,42,49,24,30,37,47,5,0
