0,5,47,45,25,49,1,17,26,11,28,49
5,0,20,37,37,25,31,8,12,21,33,3
47,20,0,20,19,7,41,23,28,18,42,18
45,37,20,0,9,40,44,40,21,30,36,11
25,37,19,9,0,8,32,26,8,11,35,45
49,25,7,40,8,0,9,6,8,23,9,33
1,31,41,44,32,9,0,4,20,50,46,39
17,8,23,40,26,6,4,0,42,50,24,49
26,12,28,21,8,8,20,42,0,26,18,44
11,21,18,30,11,23,50,50,26,0,17,22
28,33,42,36,35,9,46,24,18,17,0,41
49,3,18,11,45,33,39,49,44,22,41,0
