0,4,6,10,5,9,9,3,6,1,1,5
4,0,2,3,8,8,6,1,2,8,10,6
6,2,0,8,5,8,5,10,5,9,5,2
10,3,8,0,3,9,8,10,1,4,6,6
5,8,5,3,0,10,8,7,5,6,2,7
9,8,8,9,10,0,4,5,9,7,5,9
9,6,5,8,8,4,0,3,8,1,10,7
3,1,10,10,7,5,3,0,1,4,3,10
6,2,5,1,5,9,8,1,0,4,10,4
1,8,9,4,6,7,1,4,4,0,2,5
1,10,5,6,2,5,10,3,10,2,0,3
5,6,2,6,7,9,7,10,4,5,3,0
