0,1,49,16,37,45,31,12,13,25,40,35
1,0,24,44,22,36,28,15,7,2,50,29
49,24,0,36,9,24,5,5,3,18,49,20
16,44,36,0,33,24,6,30,2,50,5,12
37,22,9,33,0,22,14,15,12,13,14,38
45,36,24,24,22,0,7,25,27,35,25,42
31,28,5,6,14,7,0,4,28,32,1,1
12,15,5,30,15,25,4,0,47,18,15,3
13,7,3,2,12,27,28,47,0,36,19,5
25,2,18,50,13,35,32,18,36,0,35,44
40,50,49,5,14,25,1,15,19,35,0,36
35,29,20,12,38,42,1,3,5,44,36,0
