0,34,10,27,26,36,47,36,14,43,22,15
47,0,38,45,44,15,42,35,34,37,46,48
50,14,0,44,36,41,8,24,42,48,14,7
18,44,4,0,26,48,8,44,10,3,16,30
47,26,35,18,0,32,30,48,30,46,46,17
47,44,44,25,9,0,7,42,5,6,23,18
21,31,32,34,10,7,0,9,18,18,8,17
46,50,38,46,23,27,42,0,16,45,25,49
2,34,25,9,15,23,48,24,0,10,46,50
46,34,29,33,12,43,41,44,8,0,23,4
33,1,11,7,27,5,9,15,29,50,0,18
1,42,4,24,44,24,45,8,3,50,26,0
