0,1,6,1,6,8,8,6,4,2,3,7
4,0,7,6,3,1,7,9,9,3,1,2
2,4,0,10,9,8,1,9,10,10,8,2
2,1,3,0,7,7,5,6,2,10,7,2
3,10,6,5,0,10,4,2,1,3,8,4
4,10,8,1,3,0,8,5,5,5,9,1
3,7,5,5,9,5,0,5,2,10,8,7
8,4,6,7,8,7,4,0,7,8,2,3
1,4,6,2,7,8,4,1,0,10,2,1
6,2,5,1,6,1,8,9,9,0,8,1
2,6,6,3,10,3,7,9,6,6,0,8
2,7,4,6,10,10,3,1,1,1,6,0
