0,11,11,9,30,34,17,26,14,23,50,7
18,0,37,37,14,36,21,29,29,9,33,39
41,10,0,3,20,34,5,23,1,31,34,19
8,45,3,0,21,36,31,49,10,21,5,23
9,47,14,24,0,13,3,1,21,42,23,13
23,16,35,27,16,0,3,4,3,20,48,15
37,8,3,36,37,34,0,34,7,41,41,33
44,7,6,4,12,14,36,0,48,4,1,16
31,21,12,46,30,14,35,40,0,30,43,13
48,50,19,16,9,46,37,40,35,0,32,3
13,33,28,2,37,29,30,36,36,46,0,22
47,19,14,28,27,33,17,38,21,12,15,0
