0,1,4,1,10,4,2,3,9,6,4,1
1,0,6,4,8,1,4,7,3,8,4,2
4,6,0,9,9,7,9,2,5,1,5,7
1,4,9,0,4,1,10,4,6,7,6,1
10,8,9,4,0,3,1,9,5,8,7,10
4,1,7,1,3,0,1,10,2,8,3,6
2,4,9,10,1,1,0,8,9,4,10,7
3,7,2,4,9,10,8,0,9,10,9,6
9,3,5,6,5,2,9,9,0,2,2,4
6,8,1,7,8,8,4,10,2,0,9,7
4,4,5,6,7,3,10,9,2,9,0,5
1,2,7,1,10,6,7,6,4,7,5,0
