0,7,43,12,30,44,49,37,24,23,45,8
7,0,32,34,17,38,32,31,33,50,32,8
43,32,0,29,21,15,22,41,40,39,34,50
12,34,29,0,1,27,26,34,29,30,24,10
30,17,21,1,0,11,10,20,35,36,30,8
44,38,15,27,11,0,19,30,7,13,21,15
49,32,22,26,10,19,0,11,28,50,32,28
37,31,41,34,20,30,11,0,13,20,3,28
24,33,40,29,35,7,28,13,0,3,15,25
23,50,39,30,36,13,50,20,3,0,9,28
45,32,34,24,30,21,32,3,15,9,0,42
8,8,50,10,8,15,28,28,25,28,42,0
