0,1,40,10,15,1,32,37,2,1,2,11
20,0,14,25,24,26,31,36,10,46,9,13
16,9,0,4,44,4,32,10,37,40,1,50
8,6,35,0,37,49,32,19,45,19,20,16
25,34,14,6,0,30,15,10,43,2,35,17
3,2,22,24,26,0,44,42,46,20,4,45
16,34,3,20,9,11,0,10,23,43,29,47
13,13,13,4,23,37,11,0,35,46,23,37
8,10,1,1,42,35,35,45,0,20,5,5
7,40,13,44,9,37,28,50,40,0,33,42
26,8,2,6,3,32,32,29,48,28,0,10
33,22,27,3,39,30,1,34,6,7,27,0
