0,38,49,29,25,10,8,50,36,48,20,26
38,0,22,11,33,1,39,40,3,16,29,23
49,22,0,29,4,27,49,28,47,19,33,26
29,11,29,0,32,20,28,12,14,6,26,3
25,33,4,32,0,13,22,43,9,47,29,44
10,1,27,20,13,0,49,45,34,37,45,3
8,39,49,28,22,49,0,42,26,11,30,27
50,40,28,12,43,45,42,0,50,33,4,1
36,3,47,14,9,34,26,50,0,37,49,24
48,16,19,6,47,37,11,33,37,0,45,15
20,29,33,26,29,45,30,4,49,45,0,31
26,23,26,3,44,3,27,1,24,15,31,0
