0,38,8,10,4,50,42,41,25,9,33,21
7,0,28,17,39,47,25,3,31,25,19,5
13,41,0,50,29,38,4,29,21,44,38,31
46,50,3,0,21,9,22,1,32,37,34,22
36,46,39,29,0,27,11,6,34,23,46,39
16,35,28,42,8,0,47,15,41,14,26,2
33,19,32,31,21,20,0,5,37,32,29,40
48,49,1,13,50,14,9,0,7,35,50,30
13,38,30,25,27,17,9,14,0,24,19,29
47,26,25,34,38,21,2,17,8,0,19,4
29,47,14,44,27,27,50,41,41,22,0,27
13,23,10,45,7,29,7,38,28,17,17,0
