0,21,45,47,13,19,47,24,30,3,7,39
39,0,32,40,29,34,8,8,44,37,10,17
25,47,0,20,46,6,30,16,24,18,12,32
15,24,6,0,2,29,16,39,34,8,2,16
31,31,11,44,0,19,9,24,31,25,10,21
25,38,41,4,21,0,44,17,2,7,30,16
6,19,32,35,31,31,0,34,25,50,17,20
13,39,3,11,30,19,23,0,20,21,21,26
23,45,46,50,41,43,40,16,0,16,21,20
19,30,17,50,44,16,42,23,25,0,39,8
28,49,17,46,29,28,23,24,10,44,0,1
50,25,48,38,3,48,19,34,37,37,44,0
