0,1,11,44,44,17,23,41,21,18,48,41
18,0,31,6,6,31,45,26,16,44,49,44
1,32,0,43,19,15,26,23,45,36,32,34
40,31,2,0,35,48,26,7,24,28,24,33
26,37,35,43,0,37,26,35,37,40,47,22
2,11,40,14,10,0,6,49,1,31,50,5
35,35,29,35,30,18,0,13,49,39,18,43
23,13,48,17,49,8,41,0,4,22,41,40
47,10,20,11,24,1,36,35,0,17,48,7
12,21,39,40,16,43,29,1,21,0,49,7
16,15,6,4,33,37,8,35,8,25,0,36
26,33,34,27,14,1,45,8,8,24,3,0
