0,9,11,29,5,7,38,34,32,25,49,47
9,0,29,40,50,3,41,5,46,19,47,30
11,29,0,19,12,21,6,41,16,42,18,37
29,40,19,0,10,40,19,23,40,27,22,20
5,50,12,10,0,9,41,21,33,11,34,34
7,3,21,40,9,0,40,44,6,31,23,5
38,41,6,19,41,40,0,30,5,19,14,45
34,5,41,23,21,44,30,0,39,49,15,15
32,46,16,40,33,6,5,39,0,31,43,7
25,19,42,27,11,31,19,49,31,0,8,47
49,47,18,22,34,23,14,15,43,8,0,2
47,30,37,20,34,5,45,15,7,47,2,0
