0,4,21,11,36,5,24,23,37,46,37,1
4,0,29,30,18,48,7,38,3,22,28,30
21,29,0,16,8,14,23,21,11,9,11,34
11,30,16,0,8,35,11,48,34,47,46,39
36,18,8,8,0,25,17,45,33,15,3,17
5,48,14,35,25,0,4,26,50,2,28,38
24,7,23,11,17,4,0,15,44,42,11,26
23,38,21,48,45,26,15,0,4,10,35,34
37,3,11,34,33,50,44,4,0,3,36,36
46,22,9,47,15,2,42,10,3,0,27,1
37,28,11,46,3,28,11,35,36,27,0,9
1,30,34,39,17,38,26,34,36,1,9,0
