0,8,5,2,2,8,7,7,2,6,10,9
8,0,1,7,4,2,4,4,7,1,4,2
5,1,0,4,6,1,6,2,9,4,4,1
2,7,4,0,4,2,9,2,10,2,1,5
2,4,6,4,0,7,3,6,8,4,10,5
8,2,1,2,7,0,4,10,10,1,4,6
7,4,6,9,3,4,0,2,4,5,10,10
7,4,2,2,6,10,2,0,2,2,4,2
2,7,9,10,8,10,4,2,0,9,1,7
6,1,4,2,4,1,5,2,9,0,8,5
10,4,4,1,10,4,10,4,1,8,0,5
9,2,1,5,5,6,10,2,7,5,5,0
