0,14,26,31,5,20,21,22,28,18,5,37
21,0,44,41,28,8,2,37,38,26,50,5
31,41,0,7,7,46,34,40,36,24,46,41
21,38,21,0,25,8,19,5,26,42,17,38
24,19,20,45,0,44,26,42,34,6,1,10
16,8,34,17,8,0,27,37,32,26,5,26
35,4,20,11,8,34,0,4,43,20,27,17
23,7,10,21,26,3,34,0,3,29,29,26
34,28,2,37,31,16,3,33,0,24,40,2
40,28,1,7,20,29,6,17,34,0,34,27
32,13,33,39,23,16,11,17,48,15,0,13
20,50,24,13,10,11,14,29,46,27,3,0
