0,29,41,27,8,44,12,33,3,29,5,23
47,0,5,14,47,44,26,41,32,45,37,36
32,18,0,46,47,26,7,49,48,4,16,37
45,9,25,0,31,12,14,26,1,48,38,36
11,42,44,8,0,20,46,40,30,15,17,4
45,48,46,36,30,0,41,22,5,42,19,22
21,38,50,12,4,38,0,10,18,31,28,34
11,16,36,27,4,38,26,0,46,12,9,33
48,27,37,45,19,11,19,33,0,29,42,42
23,32,25,31,12,24,15,35,5,0,15,33
14,18,28,22,9,50,19,35,32,13,0,32
48,39,12,18,15,38,32,36,18,3,36,0
