0,3,3,5,4,6,6,9,3,1,6,5
8,0,9,2,10,4,4,8,4,10,6,8
8,8,0,2,2,6,10,10,4,3,7,2
7,8,10,0,5,2,7,10,2,9,7,2
3,2,8,10,0,6,5,4,7,7,2,1
3,7,10,1,8,0,1,1,9,10,1,1
1,6,2,4,6,1,0,8,9,6,2,8
5,8,2,8,3,1,2,0,2,7,5,8
4,9,2,6,3,6,7,1,0,8,6,7
3,1,7,5,5,10,7,8,9,0,6,10
7,4,4,7,1,6,3,6,3,5,0,7
3,2,10,8,10,8,10,9,5,6,9,0
