0,19,4,26,37,36,49,14,27,21,25,6
19,0,28,33,7,12,50,9,7,21,22,37
4,28,0,31,6,39,27,40,27,10,21,12
26,33,31,0,17,46,25,16,46,35,34,14
37,7,6,17,0,45,21,26,35,16,28,36
36,12,39,46,45,0,32,23,7,32,22,1
49,50,27,25,21,32,0,6,39,23,23,24
14,9,40,16,26,23,6,0,24,15,34,30
27,7,27,46,35,7,39,24,0,24,3,22
21,21,10,35,16,32,23,15,24,0,27,24
25,22,21,34,28,22,23,34,3,27,0,34
6,37,12,14,36,1,24,30,22,24,34,0
