0,41,43,12,3,42,11,30,1,24,45,25
11,0,9,19,14,36,32,13,37,22,20,42
47,1,0,18,37,10,46,9,33,1,3,34
36,44,14,0,10,24,8,18,44,47,38,22
47,33,12,31,0,3,33,30,8,47,3,45
23,35,36,38,46,0,33,42,46,1,40,15
26,30,17,1,39,44,0,12,49,46,36,11
9,3,37,34,23,27,22,0,15,32,34,46
26,25,42,38,35,20,48,39,0,15,3,17
36,48,45,8,38,23,15,10,1,0,6,21
6,46,41,40,44,11,9,4,48,37,0,17
36,48,46,15,36,13,25,40,19,45,37,0
