0,8,4,2,4,3,8,1,8,4,2,8
4,0,6,3,7,10,10,9,5,2,5,3
6,3,0,6,6,3,1,9,3,9,3,4
3,2,9,0,5,10,6,3,8,5,2,8
1,3,10,1,0,8,4,9,9,6,7,10
10,2,5,9,2,0,9,5,8,7,1,2
6,3,9,1,1,6,0,10,5,4,1,6
3,9,5,3,3,8,9,0,5,3,6,7
6,6,2,8,3,2,7,7,0,9,4,4
10,3,7,8,8,1,6,10,10,0,2,7
1,7,4,8,4,4,7,6,7,4,0,8
9,10,10,9,6,7,8,8,6,9,9,0
