0,34,38,47,35,46,35,6,8,45,25,34
34,0,43,29,44,45,29,44,9,44,30,8
38,43,0,25,31,46,29,35,24,18,48,36
47,29,25,0,36,37,11,31,49,26,23,4
35,44,31,36,0,29,30,44,26,3,41,28
46,45,46,37,29,0,20,22,15,6,34,32
35,29,29,11,30,20,0,13,30,1,27,18
6,44,35,31,44,22,13,0,27,3,8,20
8,9,24,49,26,15,30,27,0,43,39,48
45,44,18,26,3,6,1,3,43,0,48,35
25,30,48,23,41,34,27,8,39,48,0,5
34,8,36,4,28,32,18,20,48,35,5,0
