0,36,24,18,11,11,22,45,15,40,8,40
36,0,9,41,3,21,21,4,17,50,1,22
24,9,0,31,18,42,17,24,2,50,19,15
18,41,31,0,20,31,19,8,11,37,31,8
11,3,18,20,0,39,8,34,5,26,27,41
11,21,42,31,39,0,20,4,50,36,39,22
22,21,17,19,8,20,0,24,11,42,39,39
45,4,24,8,34,4,24,0,34,10,10,27
15,17,2,11,5,50,11,34,0,47,28,38
40,50,50,37,26,36,42,10,47,0,6,9
8,1,19,31,27,39,39,10,28,6,0,1
40,22,15,8,41,22,39,27,38,9,1,0
