0,15,8,30,27,24,6,45,27,7,32,47,21
15,0,1,44,12,6,44,39,18,38,37,20,23
8,1,0,13,40,50,13,49,24,12,21,50,37
30,44,13,0,7,33,44,31,10,41,46,42,24
27,12,40,7,0,44,4,24,39,46,15,39,4
24,6,50,33,44,0,48,31,47,40,27,34,3
6,44,13,44,4,48,0,26,18,48,24,1,17
45,39,49,31,24,31,26,0,17,8,28,9,13
27,18,24,10,39,47,18,17,0,23,50,23,19
7,38,12,41,46,40,48,8,23,0,45,48,41
32,37,21,46,15,27,24,28,50,45,0,42,50
47,20,50,42,39,34,1,9,23,48,42,0,41
21,23,37,24,4,3,17,13,19,41,50,41,0
