0,10,8,7,3,7,6,6,2,1,8,2,9
6,0,9,2,8,9,6,7,6,4,9,2,6
8,5,0,4,1,4,5,4,10,10,2,6,5
5,10,2,0,9,6,7,9,8,2,9,8,3
4,6,3,6,0,3,1,7,1,9,9,9,7
7,4,4,10,3,0,10,1,9,8,10,1,8
10,5,4,7,10,10,0,10,8,9,9,8,9
10,5,9,7,2,1,10,0,7,6,7,7,4
2,10,7,3,6,2,10,7,0,10,10,4,2
3,1,8,9,9,6,10,6,9,0,6,9,3
1,3,3,1,3,7,4,7,7,5,0,8,5
4,3,9,9,5,2,1,5,2,8,9,0,6
2,7,1,9,6,3,1,4,6,1,4,3,0
