0,3,32,50,23,19,17,37,41,16,50,42,40
3,0,4,50,27,12,47,3,23,12,47,46,11
32,4,0,14,21,39,24,8,5,48,35,4,39
50,50,14,0,37,8,39,38,31,8,9,16,9
23,27,21,37,0,15,40,12,5,38,42,49,45
19,12,39,8,15,0,28,33,12,34,33,49,46
17,47,24,39,40,28,0,29,47,17,13,12,46
37,3,8,38,12,33,29,0,24,32,14,37,42
41,23,5,31,5,12,47,24,0,50,47,21,11
16,12,48,8,38,34,17,32,50,0,42,33,41
50,47,35,9,42,33,13,14,47,42,0,48,32
42,46,4,16,49,49,12,37,21,33,48,0,2
40,11,39,9,45,46,46,42,11,41,32,2,0
