0,30,40,22,29,12,9,49,47,15,49,35,38
30,0,12,32,23,16,31,12,12,41,48,39,50
40,12,0,3,47,23,42,12,22,8,5,50,34
22,32,3,0,17,26,25,33,30,24,36,11,13
29,23,47,17,0,29,29,37,23,13,1,38,7
12,16,23,26,29,0,46,28,2,38,21,1,49
9,31,42,25,29,46,0,5,50,31,21,36,30
49,12,12,33,37,28,5,0,36,46,14,17,50
47,12,22,30,23,2,50,36,0,15,17,8,8
15,41,8,24,13,38,31,46,15,0,7,46,12
49,48,5,36,1,21,21,14,17,7,0,3,24
35,39,50,11,38,1,36,17,8,46,3,0,16
38,50,34,13,7,49,30,50,8,12,24,16,0
