0,33,18,6,21,38,37,19,49,22,14,46,29
39,0,42,31,26,32,19,43,45,20,20,6,4
6,43,0,32,11,28,23,5,23,40,1,4,19
6,28,25,0,48,19,40,7,45,44,46,30,21
7,7,31,27,0,29,35,37,24,30,47,32,35
2,20,47,12,23,0,28,3,35,33,25,42,13
40,18,40,39,15,27,0,17,9,2,1,10,32
34,37,49,2,14,38,33,0,9,49,1,3,50
22,14,23,26,16,39,41,16,0,27,11,40,20
16,31,2,48,15,20,21,25,9,0,10,25,40
32,12,12,48,14,43,43,9,23,27,0,35,50
9,25,16,7,34,30,5,40,11,45,29,0,26
9,5,35,22,27,47,6,40,30,17,4,2,0
