0,1,46,18,38,26,41,28,35,50,43,18,48
1,0,16,16,36,4,26,1,3,34,6,9,5
46,16,0,43,1,6,31,23,23,7,11,26,27
18,16,43,0,4,35,4,42,8,2,31,31,44
38,36,1,4,0,25,16,16,43,40,19,11,48
26,4,6,35,25,0,7,43,13,23,40,11,3
41,26,31,4,16,7,0,2,33,1,44,26,22
28,1,23,42,16,43,2,0,40,17,26,18,37
35,3,23,8,43,13,33,40,0,35,29,20,9
50,34,7,2,40,23,1,17,35,0,49,6,7
43,6,11,31,19,40,44,26,29,49,0,22,38
18,9,26,31,11,11,26,18,20,6,22,0,37
48,5,27,44,48,3,22,37,9,7,38,37,0
