0,34,44,24,15,5,20,20,23,31,41,15,11
8,0,31,18,7,47,9,12,41,12,8,1,31
5,38,0,41,2,5,4,43,23,38,45,49,35
28,19,14,0,20,44,24,34,37,18,37,35,30
48,11,15,1,0,19,48,30,6,3,23,38,49
24,10,50,46,2,0,39,23,28,3,1,3,40
24,12,49,24,29,28,0,36,6,37,6,23,23
27,34,37,8,7,27,26,0,30,27,50,19,50
29,6,5,20,8,37,21,41,0,43,17,21,3
13,22,30,50,6,40,39,14,46,0,27,6,41
18,12,3,48,14,14,5,8,3,45,0,47,25
40,29,35,34,47,43,27,32,31,45,7,0,50
25,1,44,7,14,12,27,13,31,12,4,25,0
