0,48,34,29,10,19,45,49,44,2,2,1,25
48,0,45,36,20,14,12,9,48,10,15,12,49
34,45,0,25,26,20,34,3,33,41,12,13,48
29,36,25,0,13,3,41,38,42,48,20,9,12
10,20,26,13,0,4,1,35,29,12,24,25,22
19,14,20,3,4,0,47,30,28,31,45,36,31
45,12,34,41,1,47,0,5,2,11,44,49,1
49,9,3,38,35,30,5,0,6,11,5,8,2
44,48,33,42,29,28,2,6,0,3,8,23,4
2,10,41,48,12,31,11,11,3,0,46,2,9
2,15,12,20,24,45,44,5,8,46,0,13,47
1,12,13,9,25,36,49,8,23,2,13,0,5
25,49,48,12,22,31,1,2,4,9,47,5,0
