0,10,4,2,9,10,8,6,1,6,1,3,1
10,0,3,7,9,9,5,10,6,10,5,7,1
4,3,0,3,10,10,7,7,9,8,8,8,5
2,7,3,0,8,1,1,7,9,4,1,8,6
9,9,10,8,0,4,4,2,8,7,7,7,6
10,9,10,1,4,0,8,5,2,5,9,5,2
8,5,7,1,4,8,0,5,7,9,10,1,7
6,10,7,7,2,5,5,0,8,9,6,8,2
1,6,9,9,8,2,7,8,0,8,9,8,8
6,10,8,4,7,5,9,9,8,0,4,6,6
1,5,8,1,7,9,10,6,9,4,0,9,7
3,7,8,8,7,5,1,8,8,6,9,0,2
1,1,5,6,6,2,7,2,8,6,7,2,0
