0,5,8,3,1,6,9,3,4,8,6,7,3
5,0,10,1,3,4,10,3,4,8,7,7,1
8,10,0,7,5,9,3,6,5,2,4,9,9
3,1,7,0,8,5,8,8,1,2,6,3,4
1,3,5,8,0,9,6,5,1,9,7,10,2
6,4,9,5,9,0,8,7,7,4,8,8,10
9,10,3,8,6,8,0,4,4,8,10,6,7
3,3,6,8,5,7,4,0,10,9,1,7,4
4,4,5,1,1,7,4,10,0,2,6,1,7
8,8,2,2,9,4,8,9,2,0,6,6,7
6,7,4,6,7,8,10,1,6,6,0,5,10
7,7,9,3,10,8,6,7,1,6,5,0,9
3,1,9,4,2,10,7,4,7,7,10,9,0
