0,25,35,33,17,6,15,42,26,19,50,22,29
36,0,33,47,15,30,26,19,25,35,27,25,41
34,14,0,2,33,11,2,4,35,14,8,27,1
40,37,3,0,46,2,3,32,45,27,26,24,13
39,4,5,44,0,18,1,45,16,39,21,6,46
32,44,35,35,22,0,11,13,33,33,15,25,3
20,37,13,20,13,36,0,47,39,1,24,13,48
36,47,7,39,4,6,39,0,45,44,29,31,46
50,3,20,28,11,12,44,12,0,11,40,8,37
29,28,28,13,5,25,44,8,41,0,8,31,10
17,34,25,28,22,23,31,42,12,41,0,16,14
47,26,22,30,4,15,18,44,46,17,48,0,41
7,29,28,19,47,22,17,24,14,29,22,7,0
