0,17,6,14,39,24,14,17,6,8,7,28,5
22,0,39,8,22,7,39,7,23,3,9,28,2
21,36,0,39,38,32,30,45,16,20,50,13,17
43,7,36,0,50,9,30,17,15,41,24,2,30
2,6,46,50,0,18,30,5,21,36,43,17,11
17,12,33,41,47,0,2,9,28,31,14,36,11
28,50,13,33,47,5,0,49,14,17,23,25,9
4,44,17,47,17,37,18,0,31,1,12,25,6
17,16,37,7,10,45,21,34,0,31,30,45,48
4,14,12,19,27,45,35,50,28,0,30,42,18
10,41,47,15,10,11,9,46,4,10,0,41,35
9,50,40,45,32,23,5,29,15,26,7,0,21
11,43,48,40,37,34,49,33,43,6,20,13,0
