0,6,6,10,4,5,2,5,8,7,3,7,5
7,0,9,7,7,2,4,8,5,3,6,6,9
9,5,0,5,2,7,2,9,1,6,3,5,9
10,10,10,0,3,10,9,5,1,6,2,3,7
9,8,2,1,0,7,6,6,9,5,3,7,7
6,3,10,8,9,0,3,3,2,9,8,3,10
10,3,3,2,10,9,0,1,4,1,3,9,7
1,1,1,9,5,9,1,0,4,3,8,2,1
10,1,3,6,6,1,8,2,0,3,4,7,4
10,1,10,7,3,6,6,5,8,0,4,2,10
4,5,3,3,7,1,9,9,9,5,0,4,7
2,4,6,8,2,8,9,5,6,6,7,0,2
3,8,10,6,6,8,1,2,10,4,4,2,0
