0,36,19,15,14,19,49,12,15,26,50,19,19
36,0,21,31,25,16,38,47,22,12,46,45,49
19,21,0,26,31,12,45,9,40,13,1,45,28
15,31,26,0,47,33,15,14,19,14,29,45,21
14,25,31,47,0,30,8,47,42,42,2,47,44
19,16,12,33,30,0,49,48,30,1,24,16,50
49,38,45,15,8,49,0,12,15,32,44,11,20
12,47,9,14,47,48,12,0,26,40,28,5,32
15,22,40,19,42,30,15,26,0,9,33,34,10
26,12,13,14,42,1,32,40,9,0,19,28,37
50,46,1,29,2,24,44,28,33,19,0,14,17
19,45,45,45,47,16,11,5,34,28,14,0,38
19,49,28,21,44,50,20,32,10,37,17,38,0
