0,35,27,2,11,43,17,47,28,7,25,18,12
31,0,15,31,8,5,15,12,6,8,13,48,40
41,4,0,32,10,46,6,33,41,16,26,7,44
43,43,9,0,29,38,4,41,31,49,11,43,45
5,32,33,3,0,11,44,27,11,21,23,38,36
46,3,15,23,28,0,20,49,22,8,16,3,23
15,27,32,3,37,17,0,19,14,19,43,36,25
9,13,33,34,3,46,2,0,29,44,12,12,31
50,44,21,28,1,17,28,31,0,26,34,45,24
50,46,44,31,33,6,17,49,25,0,39,15,23
38,48,48,8,50,2,20,39,18,18,0,40,41
1,16,12,4,44,33,38,22,24,1,4,0,26
44,22,1,44,26,21,28,46,23,22,45,22,0
