0,1,10,10,2,2,8,5,2,9,4,5,5
3,0,1,1,6,8,3,3,1,4,8,1,7
9,2,0,1,1,10,4,3,8,8,1,8,1
5,2,7,0,6,6,5,7,10,9,9,8,2
2,1,5,6,0,7,5,4,9,2,8,7,10
1,1,1,10,1,0,10,2,5,5,1,1,5
10,5,3,9,3,1,0,2,3,7,7,1,5
2,4,6,6,8,3,1,0,6,5,7,9,5
8,2,4,8,5,2,8,5,0,4,3,2,5
7,10,8,10,7,5,5,6,9,0,4,6,6
2,8,4,9,7,8,10,3,6,7,0,1,3
7,7,2,7,8,7,4,2,2,9,2,0,5
4,4,3,7,7,4,5,4,9,8,2,1,0
