0,28,23,35,27,1,31,48,6,12,10,35,43
23,0,2,21,38,13,14,7,13,7,34,8,46
2,5,0,44,46,31,10,11,42,6,16,2,49
21,27,40,0,35,7,31,41,16,6,37,45,42
2,35,15,31,0,5,50,10,5,23,4,3,7
27,18,24,46,3,0,24,27,38,35,47,31,7
5,11,23,45,8,14,0,20,42,38,33,38,39
48,7,49,7,4,23,23,0,17,31,42,50,6
48,46,28,39,4,30,37,39,0,14,16,44,3
43,36,19,36,46,28,44,21,21,0,45,37,19
9,44,49,27,32,31,46,14,48,6,0,26,17
44,1,45,11,36,20,16,14,8,18,28,0,49
17,6,8,46,5,3,13,27,20,40,16,13,0
