0,7,3,8,1,2,7,7,10,7,6,10,4
7,0,6,6,9,4,9,9,8,7,3,4,2
3,6,0,7,4,8,5,10,9,8,6,5,4
8,6,7,0,9,10,6,10,2,9,3,1,3
1,9,4,9,0,9,10,7,7,9,4,7,8
2,4,8,10,9,0,6,5,5,3,1,6,4
7,9,5,6,10,6,0,1,3,7,9,9,2
7,9,10,10,7,5,1,0,4,8,5,4,5
10,8,9,2,7,5,3,4,0,10,4,1,8
7,7,8,9,9,3,7,8,10,0,2,6,1
6,3,6,3,4,1,9,5,4,2,0,6,10
10,4,5,1,7,6,9,4,1,6,6,0,8
4,2,4,3,8,4,2,5,8,1,10,8,0
