0,47,46,13,27,47,18,50,11,32,42,4,25
25,0,11,1,25,9,16,10,34,15,42,35,19
6,38,0,1,5,33,7,18,33,40,47,34,34
18,50,44,0,3,46,46,33,50,2,10,19,8
44,31,50,27,0,10,34,8,3,35,7,45,14
35,17,49,41,23,0,25,35,7,33,5,29,28
2,26,21,47,7,24,0,24,37,43,20,35,9
41,6,7,13,9,12,11,0,40,22,14,50,19
37,44,21,7,30,29,21,15,0,3,24,4,38
26,7,22,7,48,11,49,20,20,0,38,5,41
46,22,1,9,4,6,44,50,15,22,0,5,32
27,26,27,35,17,48,5,48,12,48,14,0,20
31,34,6,41,29,32,11,1,43,14,17,47,0
