0,22,48,7,7,38,29,30,38,33,23,13,28
22,0,22,24,19,47,20,46,11,47,35,11,7
48,22,0,6,36,25,24,2,21,1,5,35,27
7,24,6,0,25,48,23,34,35,37,43,1,48
7,19,36,25,0,21,50,20,40,4,43,3,1
38,47,25,48,21,0,16,25,49,45,15,45,19
29,20,24,23,50,16,0,41,21,21,9,33,48
30,46,2,34,20,25,41,0,5,48,37,39,25
38,11,21,35,40,49,21,5,0,26,33,48,40
33,47,1,37,4,45,21,48,26,0,25,25,43
23,35,5,43,43,15,9,37,33,25,0,49,14
13,11,35,1,3,45,33,39,48,25,49,0,10
28,7,27,48,1,19,48,25,40,43,14,10,0
