0,33,2,25,39,1,16,4,46,3,46,42,25
6,0,6,26,28,50,13,30,36,43,49,31,45
47,42,0,8,14,44,40,38,25,37,46,47,27
16,42,2,0,27,13,20,24,25,8,20,13,12
34,31,17,15,0,6,15,50,48,8,37,19,41
38,9,43,35,22,0,21,29,41,10,17,46,7
15,43,23,36,34,35,0,36,43,19,32,49,47
46,42,49,38,30,5,42,0,4,29,49,37,46
48,32,3,28,25,33,27,22,0,33,40,19,4
44,36,46,2,8,38,16,18,19,0,11,40,17
24,10,11,31,10,18,42,38,38,29,0,33,44
28,7,17,47,39,22,29,2,43,20,27,0,23
45,5,43,24,44,47,20,44,48,16,8,38,0
