0,44,11,9,13,28,39,44,29,5,10,4,44
44,0,5,19,16,33,25,25,17,13,11,20,1
11,5,0,1,29,18,36,20,32,45,21,7,10
9,19,1,0,7,20,46,29,50,18,43,21,2
13,16,29,7,0,26,33,39,44,48,40,23,40
28,33,18,20,26,0,23,36,33,32,44,32,43
39,25,36,46,33,23,0,25,50,20,16,49,46
44,25,20,29,39,36,25,0,4,35,33,42,40
29,17,32,50,44,33,50,4,0,27,48,47,31
5,13,45,18,48,32,20,35,27,0,43,47,26
10,11,21,43,40,44,16,33,48,43,0,27,13
4,20,7,21,23,32,49,42,47,47,27,0,42
44,1,10,2,40,43,46,40,31,26,13,42,0
