0,11,2,20,42,20,31,17,37,47,35,10,18
11,0,29,20,49,43,45,25,4,32,42,14,4
2,29,0,13,31,32,18,13,37,1,34,37,31
20,20,13,0,24,23,2,27,15,42,40,9,37
42,49,31,24,0,49,47,8,27,24,9,47,34
20,43,32,23,49,0,28,7,38,7,43,20,2
31,45,18,2,47,28,0,29,7,4,40,23,22
17,25,13,27,8,7,29,0,19,44,25,8,3
37,4,37,15,27,38,7,19,0,33,29,1,11
47,32,1,42,24,7,4,44,33,0,36,10,17
35,42,34,40,9,43,40,25,29,36,0,45,24
10,14,37,9,47,20,23,8,1,10,45,0,48
18,4,31,37,34,2,22,3,11,17,24,48,0
