0,44,18,44,7,29,17,47,19,6,19,4,12
44,0,20,7,21,19,38,8,40,8,42,3,4
18,20,0,1,4,43,21,29,16,12,1,34,21
44,7,1,0,2,9,3,36,13,44,36,44,4
7,21,4,2,0,10,38,49,42,2,44,6,44
29,19,43,9,10,0,16,23,22,7,31,36,39
17,38,21,3,38,16,0,42,42,47,50,47,7
47,8,29,36,49,23,42,0,40,22,46,11,15
19,40,16,13,42,22,42,40,0,43,43,42,42
6,8,12,44,2,7,47,22,43,0,27,44,29
19,42,1,36,44,31,50,46,43,27,0,19,22
4,3,34,44,6,36,47,11,42,44,19,0,6
12,4,21,4,44,39,7,15,42,29,22,6,0
