0,22,44,35,32,39,18,8,17,36,47,10,21
32,0,48,40,42,20,5,6,45,41,17,15,47
32,33,0,8,24,34,42,21,11,18,6,34,25
37,35,33,0,29,4,29,43,32,16,39,8,8
17,35,35,25,0,18,4,4,32,20,37,42,36
42,19,6,27,22,0,23,8,42,12,14,43,37
27,45,33,1,28,38,0,7,2,47,45,20,26
50,3,9,2,14,4,6,0,37,9,50,26,14
18,15,22,46,5,7,31,1,0,35,36,36,26
38,24,39,29,18,29,34,43,34,0,31,33,24
23,44,41,22,39,49,39,16,2,13,0,44,47
48,7,44,23,2,10,12,11,6,2,3,0,48
22,4,39,17,2,29,32,32,39,31,50,2,0
