0,19,44,9,50,16,46,47,50,47,10,44,13
11,0,21,29,46,27,17,33,23,26,39,50,9
18,31,0,17,36,16,7,43,29,31,28,39,3
30,41,15,0,26,42,27,49,21,23,34,45,17
39,34,13,48,0,45,13,36,42,4,20,17,48
21,29,7,7,29,0,6,20,12,15,11,4,35
44,39,12,9,20,42,0,16,4,36,37,41,18
20,43,6,41,50,25,23,0,27,3,36,4,9
30,21,8,39,1,47,47,41,0,11,40,45,4
5,8,17,4,28,27,10,18,35,0,36,42,42
14,26,36,24,16,17,42,46,47,9,0,46,16
28,37,29,38,27,33,21,3,35,50,14,0,7
13,23,34,36,37,11,44,9,14,30,18,10,0
