0,3,2,1,6,3
3,0,4,3,5,6
2,4,0,6,6,2
1,3,6,0,7,9
6,5,6,7,0,8
3,6,2,9,8,0
