0,8,4,8,5,6,7
8,0,3,9,9,7,8
9,6,0,7,4,1,9
9,7,5,0,6,6,8
5,1,8,4,0,8,5
1,3,1,9,2,0,7
7,1,3,1,5,6,0
