0,4,8,7,8,4,5
4,0,5,1,4,9,4
6,1,0,2,1,5,1
9,5,7,0,7,1,5
8,2,9,1,0,4,8
10,6,3,7,3,0,9
1,4,2,7,1,1,0
