0,6,6,7,9,3,6
6,0,5,6,1,4,10
6,5,0,9,8,9,3
7,6,9,0,2,4,2
9,1,8,2,0,8,8
3,4,9,4,8,0,6
6,10,3,2,8,6,0
