0,7,5,5,7,8,1
7,0,7,1,3,2,2
5,7,0,9,8,10,1
5,1,9,0,4,8,4
7,3,8,4,0,2,2
8,2,10,8,2,0,2
1,2,1,4,2,2,0
