0,6,26,29,20,26,9,44
45,0,49,15,16,4,41,1
38,41,0,49,46,43,47,34
13,16,14,0,46,45,29,36
19,17,40,8,0,8,39,3
39,25,21,8,35,0,31,24
40,42,40,28,47,2,0,20
36,8,5,12,23,3,26,0
