0,3,44,20,5,50,23,5
32,0,42,25,42,31,2,30
16,15,0,13,49,30,2,33
16,1,25,0,6,34,1,26
27,23,10,5,0,6,46,8
15,2,4,13,35,0,21,10
42,39,47,35,29,19,0,46
36,8,11,25,32,26,21,0
