0,45,35,20,10,45,34,9
7,0,43,16,38,24,3,37
15,21,0,9,38,39,30,1
18,8,2,0,24,29,34,2
19,31,9,6,0,35,26,29
3,25,11,22,34,0,31,15
7,6,25,2,22,13,0,13
45,37,49,4,36,50,36,0
