0,30,41,31,32,44,42,9
12,0,11,48,34,10,34,39
41,12,0,40,29,44,21,48
4,12,14,0,15,30,19,33
16,29,43,27,0,15,12,2
19,50,16,44,4,0,9,21
38,39,18,17,38,18,0,49
20,34,20,23,49,15,19,0
