0,47,38,43,14,12,27,14
1,0,42,13,7,44,5,23
45,43,0,12,21,8,44,3
6,12,25,0,34,31,48,33
21,9,39,44,0,43,40,28
8,14,26,9,20,0,17,6
42,20,33,10,20,35,0,43
31,39,32,46,49,8,35,0
