0,7,8,9,4,10,10,6
8,0,6,3,8,9,8,7
7,10,0,10,2,2,4,9
9,9,8,0,6,3,7,1
5,5,6,8,0,7,3,4
10,2,3,10,6,0,2,10
9,6,1,8,5,4,0,5
10,6,1,9,10,6,10,0
