0,38,26,17,49,4,4,20
13,0,37,14,38,15,37,6
8,29,0,34,11,20,26,17
26,21,36,0,26,42,49,23
21,46,1,48,0,38,38,24
10,46,23,50,18,0,37,5
4,26,27,12,29,44,0,3
31,32,15,10,5,25,44,0
