0,24,20,48,23,16,43,22
6,0,45,24,20,46,9,40
1,2,0,9,13,30,9,8
28,30,1,0,34,3,35,6
11,11,28,5,0,11,6,27
30,20,31,11,43,0,6,1
8,11,39,3,5,8,0,13
1,40,32,43,8,45,10,0
