0,18,29,6,36,7,46,47
35,0,31,1,14,7,33,48
19,19,0,12,17,27,2,36
25,10,19,0,15,45,18,37
44,33,8,28,0,40,10,40
36,43,50,12,30,0,36,4
8,14,28,47,46,1,0,30
5,17,3,12,36,44,6,0
