0,41,10,10,8,20,24,7
22,0,4,46,31,27,34,43
38,9,0,47,50,29,26,8
39,32,35,0,14,47,32,38
7,35,14,40,0,49,14,22
46,8,23,28,30,0,44,28
47,49,14,46,6,35,0,42
10,36,22,17,3,41,43,0
