0,42,23,16,29,19,9,11
47,0,23,36,18,46,13,11
38,12,0,14,30,48,9,35
49,10,35,0,19,21,27,38
1,48,45,22,0,47,26,25
24,32,39,17,5,0,31,40
40,41,34,13,39,23,0,40
6,22,3,28,2,27,38,0
