0,9,7,9,10,6,8,3
2,0,6,3,10,9,7,10
9,2,0,2,1,5,9,9
4,3,5,0,2,8,3,1
2,6,5,10,0,7,10,10
2,8,5,4,4,0,2,1
8,5,4,3,4,8,0,5
5,1,2,7,8,6,2,0
