0,3,4,8,5,8,7,8
4,0,9,9,9,1,7,7
1,3,0,4,4,6,1,6
5,2,10,0,4,6,7,8
5,9,1,7,0,8,5,8
1,6,9,10,1,0,8,6
5,2,8,3,3,3,0,10
6,3,9,7,2,1,1,0
