0,1,11,26,46,8,26,20
1,0,38,40,48,23,23,36
11,38,0,5,40,33,1,18
26,40,5,0,10,10,4,13
46,48,40,10,0,30,24,2
8,23,33,10,30,0,47,37
26,23,1,4,24,47,0,42
20,36,18,13,2,37,42,0
