0,4,32,6,17,16,12,17
4,0,22,18,43,23,5,10
32,22,0,3,22,7,34,44
6,18,3,0,8,45,3,30
17,43,22,8,0,35,21,43
16,23,7,45,35,0,41,9
12,5,34,3,21,41,0,35
17,10,44,30,43,9,35,0
