0,10,34,22,20,23,45,7
10,0,26,44,36,8,26,43
34,26,0,23,17,10,6,24
22,44,23,0,47,32,24,11
20,36,17,47,0,6,23,4
23,8,10,32,6,0,9,14
45,26,6,24,23,9,0,48
7,43,24,11,4,14,48,0
