0,49,36,40,18,19,8,22
49,0,39,13,49,22,10,20
36,39,0,14,5,3,28,22
40,13,14,0,19,8,43,46
18,49,5,19,0,4,38,13
19,22,3,8,4,0,2,23
8,10,28,43,38,2,0,10
22,20,22,46,13,23,10,0
