0,18,18,27,31,9,35,47
18,0,38,18,32,47,23,27
18,38,0,5,13,3,43,46
27,18,5,0,43,9,34,41
31,32,13,43,0,32,28,27
9,47,3,9,32,0,19,5
35,23,43,34,28,19,0,33
47,27,46,41,27,5,33,0
