0,6,5,8,1,7,3,7
6,0,9,4,9,8,1,9
5,9,0,4,10,4,6,7
8,4,4,0,10,5,5,4
1,9,10,10,0,9,4,3
7,8,4,5,9,0,5,6
3,1,6,5,4,5,0,1
7,9,7,4,3,6,1,0
