0,1,1,9,10,5,10,4
1,0,3,10,1,6,5,9
1,3,0,4,8,8,6,4
9,10,4,0,5,6,3,3
10,1,8,5,0,7,6,10
5,6,8,6,7,0,8,6
10,5,6,3,6,8,0,7
4,9,4,3,10,6,7,0
