0,32,31,12,31,7,14,22
32,0,37,45,39,29,26,7
31,37,0,11,28,10,1,48
12,45,11,0,39,20,7,47
31,39,28,39,0,15,19,15
7,29,10,20,15,0,40,28
14,26,1,7,19,40,0,18
22,7,48,47,15,28,18,0
