0,6,4,1,3,4,5,7
6,0,5,1,2,9,8,7
4,5,0,7,7,9,1,9
1,1,7,0,9,2,8,8
3,2,7,9,0,6,1,8
4,9,9,2,6,0,1,9
5,8,1,8,1,1,0,2
7,7,9,8,8,9,2,0
