0,20,12,26,15,46,16,30
20,0,38,25,39,24,46,31
12,38,0,46,44,13,23,50
26,25,46,0,12,3,18,48
15,39,44,12,0,27,48,49
46,24,13,3,27,0,8,10
16,46,23,18,48,8,0,5
30,31,50,48,49,10,5,0
