0,5,46,5,33,25,16,13
5,0,13,6,40,48,33,44
46,13,0,16,25,38,8,47
5,6,16,0,48,13,15,45
33,40,25,48,0,22,14,47
25,48,38,13,22,0,38,9
16,33,8,15,14,38,0,17
13,44,47,45,47,9,17,0
