0,25,17,13,14,21,27,7
25,0,5,27,21,49,41,24
17,5,0,39,1,27,27,43
13,27,39,0,5,20,47,15
14,21,1,5,0,8,7,12
21,49,27,20,8,0,7,41
27,41,27,47,7,7,0,27
7,24,43,15,12,41,27,0
