0,2,48,16,20,45,28,32
2,0,25,46,32,13,30,12
48,25,0,36,35,26,35,38
16,46,36,0,40,30,33,30
20,32,35,40,0,24,40,50
45,13,26,30,24,0,22,3
28,30,35,33,40,22,0,16
32,12,38,30,50,3,16,0
