0,11,50,18,9,39,34,42,39
49,0,16,16,33,35,26,8,33
45,22,0,35,19,43,20,22,42
24,9,3,0,29,50,38,43,50
1,45,14,30,0,36,25,15,21
29,25,19,9,45,0,15,48,45
14,7,37,44,46,35,0,25,34
26,31,1,41,35,34,5,0,39
25,19,16,14,7,13,34,36,0
