0,45,29,25,27,27,27,12,1
1,0,6,8,15,13,17,11,44
29,20,0,6,39,11,2,50,47
25,42,18,0,21,21,11,27,7
8,32,2,3,0,26,11,46,50
23,33,44,36,14,0,2,32,39
36,13,23,36,10,6,0,7,2
25,29,36,7,34,15,47,0,9
26,35,29,8,23,29,28,39,0
