0,28,9,44,27,13,31,21,39
8,0,6,42,34,39,13,42,13
17,49,0,9,28,25,20,48,27
43,17,18,0,14,37,29,20,33
14,15,47,9,0,38,3,49,5
46,14,12,23,39,0,38,14,3
2,25,7,30,49,21,0,50,48
22,1,2,30,16,6,34,0,41
43,38,38,4,47,6,35,35,0
