0,28,44,4,43,21,8,6,13
33,0,22,49,36,47,39,18,39
1,24,0,16,26,32,2,7,27
8,26,8,0,48,35,22,29,20
43,3,36,35,0,12,16,18,35
39,37,26,49,1,0,31,38,24
21,8,26,40,33,33,0,42,36
34,37,7,34,31,50,34,0,2
8,23,32,5,47,19,28,15,0
