0,4,6,6,3,4,9,6,6
4,0,7,10,3,8,4,2,4
9,8,0,6,2,4,6,3,4
8,3,6,0,1,3,1,2,6
2,10,3,5,0,10,1,3,4
2,4,1,7,1,0,7,2,6
8,10,2,9,2,6,0,9,4
5,9,7,10,10,10,3,0,4
4,10,10,7,7,8,7,8,0
