0,9,10,7,10,2,6,5,10
7,0,1,2,7,10,4,4,8
10,10,0,7,9,9,6,8,5
8,6,6,0,1,6,3,7,2
7,9,4,8,0,10,10,9,10
4,4,1,1,7,0,6,6,2
3,2,9,1,2,3,0,5,3
1,9,8,8,4,3,6,0,7
1,5,8,3,3,6,3,3,0
