0,45,3,35,39,41,14,18,32
39,0,20,24,47,45,26,39,6
9,35,0,19,40,27,13,24,23
37,31,31,0,6,50,1,13,36
25,40,38,18,0,22,40,33,24
43,38,1,31,32,0,45,42,5
5,25,31,15,6,30,0,10,24
43,35,36,22,21,21,10,0,18
48,43,34,48,44,21,6,20,0
