0,4,9,19,10,1,13,41,8
30,0,41,32,23,11,49,47,27
15,46,0,10,23,14,21,32,20
8,44,47,0,41,17,24,13,15
23,12,16,27,0,43,1,2,47
32,24,19,8,40,0,19,24,45
26,26,18,45,34,50,0,49,19
29,13,39,29,20,49,19,0,46
4,21,27,25,39,34,10,23,0
