0,3,7,7,5,4,6,10,9
1,0,1,10,3,6,10,10,8
7,7,0,1,5,4,6,4,2
1,9,9,0,9,7,7,6,6
3,8,2,7,0,10,1,6,8
10,5,4,9,8,0,5,7,8
3,7,8,10,9,5,0,7,4
3,5,8,2,9,8,5,0,7
7,2,8,10,8,4,3,1,0
