0,26,27,23,36,32,39,43,6
50,0,30,8,33,35,41,23,36
7,31,0,14,20,44,43,33,12
9,9,5,0,40,50,1,24,22
37,22,10,43,0,27,27,11,39
26,30,38,39,11,0,26,41,19
15,6,27,12,36,32,0,45,50
15,16,34,25,32,11,29,0,31
1,31,21,6,16,44,23,11,0
