0,9,46,9,12,7,2,28,33
18,0,35,3,14,21,26,16,32
9,44,0,27,47,12,30,45,50
8,40,14,0,50,48,20,10,28
18,15,31,13,0,6,10,36,28
9,16,10,11,2,0,48,8,35
43,25,33,12,9,15,0,49,9
25,50,34,44,23,45,14,0,44
44,46,46,43,38,45,50,14,0
