0,23,7,1,27,6,19,30,48
26,0,16,50,1,50,19,20,3
39,16,0,43,45,50,27,21,38
34,29,18,0,16,28,8,38,29
42,44,42,17,0,14,30,13,38
41,8,11,21,28,0,43,20,30
44,45,9,14,21,27,0,10,16
3,19,15,5,1,33,28,0,48
41,38,48,37,23,18,20,12,0
