0,31,30,25,16,1,4,46,12
48,0,22,47,40,25,16,16,23
3,25,0,30,2,13,5,50,43
11,50,27,0,5,26,44,28,33
38,14,39,13,0,18,47,4,8
21,35,45,8,12,0,39,4,14
5,22,32,25,49,40,0,5,9
4,16,50,48,44,43,9,0,15
21,14,42,37,33,32,6,38,0
