0,50,38,2,28,37,24,28,50
50,0,31,8,21,43,6,6,13
38,31,0,46,36,21,28,22,13
2,8,46,0,8,35,32,34,37
28,21,36,8,0,12,35,10,47
37,43,21,35,12,0,8,11,14
24,6,28,32,35,8,0,28,12
28,6,22,34,10,11,28,0,20
50,13,13,37,47,14,12,20,0
