0,45,22,41,25,17,22,34,26
45,0,29,2,40,45,26,45,41
22,29,0,15,43,11,46,1,19
41,2,15,0,47,11,24,9,30
25,40,43,47,0,41,29,28,39
17,45,11,11,41,0,10,34,6
22,26,46,24,29,10,0,41,21
34,45,1,9,28,34,41,0,26
26,41,19,30,39,6,21,26,0
