0,24,41,20,47,30,3,11,30
24,0,19,50,49,16,37,28,39
41,19,0,14,29,2,21,29,29
20,50,14,0,48,2,31,19,37
47,49,29,48,0,22,43,14,8
30,16,2,2,22,0,45,3,45
3,37,21,31,43,45,0,42,49
11,28,29,19,14,3,42,0,46
30,39,29,37,8,45,49,46,0
