0,1,8,2,3,2,3,8,4
1,0,9,10,10,9,4,2,8
8,9,0,8,3,5,2,8,1
2,10,8,0,1,4,8,5,2
3,10,3,1,0,10,2,10,4
2,9,5,4,10,0,5,2,4
3,4,2,8,2,5,0,2,7
8,2,8,5,10,2,2,0,7
4,8,1,2,4,4,7,7,0
