0,8,3,5,8,5,4,10,2
8,0,1,8,6,5,6,2,4
3,1,0,4,1,5,9,7,7
5,8,4,0,1,10,4,3,4
8,6,1,1,0,10,8,4,6
5,5,5,10,10,0,2,10,2
4,6,9,4,8,2,0,4,4
10,2,7,3,4,10,4,0,6
2,4,7,4,6,2,4,6,0
