0,38,15,37,11,23,35,42,17
38,0,22,15,19,9,9,13,38
15,22,0,5,22,7,5,9,36
37,15,5,0,33,20,44,12,45
11,19,22,33,0,34,35,17,4
23,9,7,20,34,0,45,49,24
35,9,5,44,35,45,0,30,49
42,13,9,12,17,49,30,0,10
17,38,36,45,4,24,49,10,0
