0,15,3,2,37,24,10,49,26
15,0,47,15,30,3,26,6,19
3,47,0,12,43,12,18,12,41
2,15,12,0,6,45,34,47,26
37,30,43,6,0,24,35,20,34
24,3,12,45,24,0,19,27,39
10,26,18,34,35,19,0,25,11
49,6,12,47,20,27,25,0,50
26,19,41,26,34,39,11,50,0
