0,26,23,36,31,43,29,34,9
26,0,36,45,2,36,44,36,48
23,36,0,18,38,49,22,35,37
36,45,18,0,27,32,11,5,33
31,2,38,27,0,2,48,20,30
43,36,49,32,2,0,46,45,45
29,44,22,11,48,46,0,49,4
34,36,35,5,20,45,49,0,20
9,48,37,33,30,45,4,20,0
