0,33,34,45,11,21,26,32,49
33,0,29,29,46,6,31,40,50
34,29,0,35,20,28,32,25,13
45,29,35,0,29,10,50,36,34
11,46,20,29,0,29,11,13,5
21,6,28,10,29,0,44,1,45
26,31,32,50,11,44,0,1,20
32,40,25,36,13,1,1,0,39
49,50,13,34,5,45,20,39,0
