0,8,9,36,25,41,48,37,41
8,0,12,10,46,10,50,46,47
9,12,0,14,8,4,1,7,7
36,10,14,0,48,2,48,38,43
25,46,8,48,0,44,3,3,3
41,10,4,2,44,0,40,31,18
48,50,1,48,3,40,0,19,30
37,46,7,38,3,31,19,0,39
41,47,7,43,3,18,30,39,0
