0,10,5,5,4,4,10,5,10
10,0,4,8,5,4,8,5,8
5,4,0,3,9,4,7,7,10
5,8,3,0,3,5,6,8,4
4,5,9,3,0,1,6,3,10
4,4,4,5,1,0,3,8,4
10,8,7,6,6,3,0,1,3
5,5,7,8,3,8,1,0,10
10,8,10,4,10,4,3,10,0
