0,15,1,14,4,32,41,18,24
15,0,45,43,15,46,14,14,6
1,45,0,10,5,47,14,10,21
14,43,10,0,34,44,50,41,35
4,15,5,34,0,40,45,37,43
32,46,47,44,40,0,6,13,50
41,14,14,50,45,6,0,34,39
18,14,10,41,37,13,34,0,32
24,6,21,35,43,50,39,32,0
