0,31,17,19,17,40,44,47,32
31,0,32,33,41,3,45,40,47
17,32,0,10,24,19,16,22,43
19,33,10,0,28,2,9,32,34
17,41,24,28,0,33,49,11,20
40,3,19,2,33,0,45,39,34
44,45,16,9,49,45,0,15,34
47,40,22,32,11,39,15,0,9
32,47,43,34,20,34,34,9,0
