0,1,2,3,4,2,6,9
1,0,1,2,5,6,7,3
2,1,0,3,4,5,3,2
1,2,3,0,5,1,6,3
4,2,6,9,0,5,6,7
3,4,2,6,9,0,3,4
5,1,4,2,6,5,0,8
7,2,1,5,2,2,5,0